Victoria	May
Eric	Russell
Max	Davies
Ruth	Mackenzie
Stewart	Ferguson
Bernadette	Alsop
Sebastian	Rutherford
Heather	Sutherland
Stewart	Paige
Katherine	Davidson
Blake	Springer
Edward	Parsons
Keith	Gibson
Hannah	Smith
Amy	Tucker
Samantha	Paige
Dan	Baker
Peter	Nash
James	Davies
Una	Gibson