Emily	McLean
Sebastian	Sharp
Bernadette	Bell
Ava	Burgess
Steven	Hart
Blake	Springer
Edward	Parsons
Keith	Gibson
Hannah	Smith
Amy	Tucker
Samantha	Paige
Claire	Greene
Brian	Lambert
Dylan	Hart
Pippa	Grant
Madeleine	Manning
Dan	Baker
Peter	Nash
James	Davies
Una	Gibson